1 1 1 1 1 1 1 1 1 1 1 1
1 1 0 3 0 1 5 1 1 1 1 1
1 1 1 1 1 1 1 1 1 1 1 1
1 1 0 1 1 1 1 1 1 1 1 1
1 1 4 1 1 1 1 1 1 5 1 1
1 1 0 1 1 2 1 1 1 1 1 1
1 1 1 1 1 1 1 1 0 4 0 1
1 0 4 0 1 5 1 1 1 1 1 1
1 1 1 1 1 1 1 1 1 1 1 1
1 1 5 1 0 4 0 1 1 1 1 1
1 1 1 1 1 1 1 1 1 1 1 1
1 1 1 1 1 1 1 1 1 1 1 1