1 1 1 1 1 1 1 1 1 1 1 1
1 0 1 1 1 1 1 1 0 0 3 1
1 3 1 5 1 1 1 1 1 1 1 1
1 0 1 1 1 1 1 1 1 1 1 1
1 0 1 1 1 1 1 1 1 1 1 1
1 1 1 1 1 2 1 1 1 1 1 1
1 1 1 1 1 1 1 1 0 1 1 1
1 0 0 4 0 1 1 1 0 5 1 1
1 1 1 1 1 1 1 1 3 1 1 1
1 1 5 1 1 1 1 1 0 1 1 1
1 1 1 1 1 1 1 1 0 1 1 1
1 1 1 1 1 1 1 1 1 1 1 1