15 15 15 15 15  4 15 15 15 15 15 15
15  0 15 15 15  4 15 15  2  5  3 15
15  4 15 15 15  4 15 15 15 15 15 15
15  4 15 15 15  4 15 15 15 15 15 15
15  1 15 15 15  4 15 15 15 15 15 15
15 15 15 15  2 14  3 15 15 15 15 15
15 15 15 15 15 15 15 15  0 15 15 15
15  2  5  5  3 15 15 15  4 15 15 15
15 15 15 15 15 15 15 15  4 15 15 15
15 15 15 15 15 15 15 15  4 15 15 15
15 15 15 15 15 15 15 15  1 15 15 15
15 15 15 15 15 15 15 15 15 15 15 15